NO ./assets/42.xpm
SO ./assets/42.xpm
WE ./assets/42.xpm
EA ./assets/42.xpm

F 100,255,100
C 173,216,230

        111111111111
       10000000000001
      100011100100001
     10001  101100001
    10001    1 100001
   10001      100001
  10001      100001
 10001      100001
100011111111100001 1
100000000000000001101
1000000000N0000001001
100000000000000000001
 1111111110001111111
         10001
         10001
         10001
          111
