NO ./assets/42.xpm
SO ./assets/42.xpm
WE ./assets/42.xpm
EA ./assets/42.xpm

F 220,100,0
C 0,0,0

1
1111111111111111111111
100N00000011000001110111111111111
11110111111111011100000010001
11110111111111011101010010001
11000000110101011100000010001
10000000000000001100000010001
10000000000000001101010010001
110000011101010111110111100111
11110111 1110101 101111010001
11111111 1111111 111111111111
