NO ./assets/back2.xpm
SO ./assets/back3.xpm
WE ./assets/back4.xpm
EA ./assets/back5.xpm

F 100,255,100
C 173,216,230

1111111111111111111111111111111111111111111111111111111111111
10000000000000000000000000000000000000000000000000000000000001
100000000000000000000000000000000000000000000000000000000000001
1000010000000000000000000000000000000000000000000000000000000001
100000000W0000000000000000000000000000000000000000000000000000001
1000100000000000000000000000000000000000000000000000000000000001
100000000000000000000000000000000000000000000000000000000000001
10000000000000000000000000000000000000000000000000000000000001
111111111111111111111111111111111111111111111111111111111111
