NO ./assets/back2.xpm
SO ./assets/back3.xpm
WE ./assets/back4.xpm
EA ./assets/back5.xpm

C 173,216,230
F 100,255,100

1111111111111111111111111111111111111111
10000000000000000000000000000000000000001
100000000000000000000000000000000000000001
1000010000000000000001000000000100000000001
100000000W0000000111111000000011100000000001
100010000000000000100000000000010000000000001
111111111111111111111111111111111111111111111
11111111111111111111111111111111111111111111
10000000011100000000000000000000000000000001
1000000000000000000000000000000000000000001
111111111111111111111111111111111111111111