NO ./assets/42.xpm
SO ./assets/42.xpm
WE ./assets/42.xpm
EA ./assets/42.xpm

F 0,0,255
C 0,255,0

11111111
1000001011
100010001
1111100001
    11111
