NO ./assets/meme1.xpm
SO ./assets/meme2.xpm
WE ./assets/meme3.xpm
EA ./assets/meme4.xpm

F 100,255,100
C 173,216,230

11111111111111111111111111111111111111111111111111111111111111
10000000000000000000000000000000000000000000000000000000000001
10000000000000000000000000000000000000000000000000000000000001
100N0100000000000000000000000000000000000000000000000000000001
100000000W0000000000000000000000000000000000000000000000000001
10001000000000000000000000000000000000000000000000000000000001
10000000000000000000000000000000000000000000000000000000000001
10000000000000000000000000000000000000000000000000000000000001
11111111111111111111111111111111111111111111111111111111111111
